XXXXXXXXXXXXXXXXXXXXXXXXX
X                       X
X         P    H    P  HX
X        TTTTTTHTTTTTTTHX
X              H       HX
X              H       HX
X         H P  H       HX
X       TTHTTTTHTTT    HX
X         H    H       HX
X H C     H P  H       HX
XTHTTTTTTTHTTTTH       HX
X H       H            HX
X H   P   H       PH   HX
XTHTTTTTTTHTTTTTTTTHTT HX
X H       H        H   HX
X H  S    H        H   HX
XXXXXXXXXXXXXXXXXXXXXXXXX